###############################
#0             #              #
#  ####  ####  #  ####  ####  #
#              #             X#
#  ####  ####     ####  ####  #
#                             #
#  ####  ####     ####  ####  #
#              G              #
#  ####  ####     ####  ####  #
#P                            #
#  ####  ####  #  ####  ####  #
#              #              #
###############################

